AAAAAAAAAAAAAAAAAAAAAAAAAAAAAA
AAAAAAGCCCCCCCCCCCCCCCCHAAAAAA
AAAAAAEBBBBBBBBBBBBBBBBFAAAAAA
AAAAAAEBBBBBBBBBBBBBBBBFAAAAAA
AAAAAAEBBBBBBBBBBBBBBBBFAAAAAA
AAAAAAEBBBBBBBBBBBBBBBBFAAAAAA
AAAAAAEBBBBBBBBBBBBBBBBFAAAAAA
GCCCCCBBBBBBBBBBBBBBBBBBCCCCCH
EBBBBBBBBBBBBBBBBBBBBBBBBBBBBF
JDDDDDBBBBBBBBBBBBBBBBBBDDDDDK
AAAAAAEBBBBBBBBBBBBBBBBFAAAAAA
AAAAAAEBBBBBBBBBBBBBBBBFAAAAAA
AAAAAAEBBBBBBBBBBBBBBBBFAAAAAA
AAAAAAEBBBBBBBBBBBBBBBBFAAAAAA
AAAAAAEBBBBBBBBBBBBBBBBFAAAAAA
AAAAAAJDDDDDDDDDDDDDDDDKAAAAAA
AAAAAAAAAAAAAAAAAAAAAAAAAAAAAA