###### ######
#....###....#
#....|.|....#
#....###....#
###### ###### 